...#.......#E####........#
.#...#.....#.##.........##
.#.........#.....#######.#
..##......##..............
.#.###....................
.#...........###.......###
......#....#.....###......
###..#................###S
